13 20                                    // number of row and column
0 2                                        // coordinates of the start point
00100000000000000000
00111111110000000000
00010100011111000000
00011000110000000000
01110000100000000000
00001111100000000000
00110010000000000000
00100010000000000000
00111110000000000000
00100100000000000000
00111111100000000000
00111111111111111111
00000000000000000000
